[
  {
    "type": "mapgen",
    "om_terrain": [ "necromancy_test_location" ],
    "weight": 100,
    "object": {
      "fill_ter": "t_grass",
      "rows": [
        "########################",
        "#......................#",
        "#......................#",
        "#......................#",
        "#......................#",
        "#.........ooo..........#",
        "#.........o_o..........#",
        "#.........ooo..........#",
        "#......................#",
        "#......................#",
        "#......................#",
        "#......................#",
        "#......................#",
        "#......................#",
        "#......................#",
        "#......................#",
        "#......................#",
        "#......................#",
        "#......................#",
        "#......................#",
        "#......................#",
        "#......................#",
        "#......................#",
        "########################"
      ],
      "terrain": { "#": "t_wall", ".": "t_floor", "o": "t_necromancy_ritual_circle" },
      "furniture": { "_": "f_necromancy_altar" },
      "items": { "_": { "item": "necromancy_loot", "chance": 100 } }
    }
  }
]
